##################################################
#                                                #
#                                                #
#           J                         FFF        #
#                                                #
#                                                #
#                                                #
#             ###           ###                  V
#                           ###                  #
#            C              ###                  #
#                                                #
#                                                #
#                                                #
#                                                #
##################################################